111111111111111111111111111111111111111111111111111
1P00000100000000000000000000000000000000000000000C1
101100101111111111111000000000000000000000000000001
100000000000000000000000000000000000000000000000001
100011111111111011111100000000000000000000000000001
1C0000000000000000000000000000000000000000000000001
111111111111100010111111111111111111111111111111111
1000000000001000001000E0000000000000000000000000001
10C011111100101110100000000000000000000000000000001
100010000000100000111110000000000000000000000000001
100010000000111100000000000000000000000000000000001
100000000000000000000000000000000000000000000000001
111111111111111111111111111111111111111111111111111